111111111111111111111111
100000000000000C10000C01
101001010010000010100101
10100100101010101010E101
100000000C00C00010000001
1000P0000C00C00010000001
111111111111111111111111
