111111111111111111111111
100000000000000010000001
101001010010000000100101
101001001010101010100101
100000000000000010000001
100P000000000E0010000001
111111111111111111111111
