111111111111111111111111
100000000000000C10000C01
101001010010000010100101
101001001010101010100101
100000000C00CE0010000001
100P00000C00CE0010000001
111111111111111111111111
