111111111111111111111111
1C0000000000000C00100C01
101001010010000000100101
10100100101000100010E101
100000000000C00001100001
1000P0000C00C00001100001
100000000000000000100001
1CCCCCCCCCCCCCCCCC1CCCC1
111111111111111111111111
