111111111111111111111111
110000100000000C00000C01
100000000000000000000001
10000000000000E000000001
100000000C00C0P000000001
100000000C00C00000000000
111111111111111111111111
