111111111111111111111111111111
1000C0000000000010000000000001
1000C0000000000010000000000001
1000C0000000111110000000000001
1000C00000001CCCCC000000000001
1000C00000001CCCCC000000000001
1000C00000001CCCCC000000000001
1000C00000001CCCCC000000000001
1000C00000001CCCCC000000000001
1000C00000001CCCCC000000000001
1111C11111111CCCCC111111111111
1111C00000001CCCCC111111111111
1100C00000001CCCCC000000000001
1CP1C11111100CCCCC00000001CCC1
1E01C11111111CCCCC00000001CCC1
111111111111111111111111111111
